stabilimetre	stabilimetre	Nom:Mas+SG
stabilisaient	stabiliser	Ver:IImp+PL+P3
stabilisais	stabiliser	Ver:IImp+SG+P1:IImp+SG+P2
stabilisai	stabiliser	Ver:IPSim+SG+P1
stabilisait	stabiliser	Ver:IImp+SG+P3
stabilisames	stabiliser	Ver:IPSim+PL+P1
stabilisant	stabilisant	Adj:Mas+SG
stabilisante	stabilisant	Adj:Fem+SG
stabilisant	stabilisant	Nom:Mas+SG
stabilisant	stabiliser	Ver:PPre
abaca	abaca	Nom:Mas+SG
stabilisassent	stabiliser	Ver:SImp+PL+P3
abaissent	abaisser	Ver:IPre+PL+P3:SPre+PL+P3
abaissera	abaisser	Ver:IFut+SG+P3
abaisser	abaisser	Ver:Inf
abaisserai	abaisser	Ver:IFut+SG+P1
abaisseraient	abaisser	Ver:CPre+PL+P3
abaisserais	abaisser	Ver:CPre+SG+P1:CPre+SG+P2
abaisserait	abaisser	Ver:CPre+SG+P3
abaisseras	abaisser	Ver:IFut+SG+P2
abaisserent	abaisser	Ver:IPSim+PL+P3
abaisserez	abaisser	Ver:IFut+PL+P2
abaisseriez	abaisser	Ver:CPre+PL+P2
abaisserions	abaisser	Ver:CPre+PL+P1
abandonnees	abandonner	Ver:PPas+Fem+PL
abandonnent	abandonner	Ver:IPre+PL+P3:SPre+PL+P3
abandonnera	abandonner	Ver:IFut+SG+P3
abandonner	abandonner	Ver:Inf
abandonnerai	abandonner	Ver:IFut+SG+P1
abandonneraient	abandonner	Ver:CPre+PL+P3
abandonnerais	abandonner	Ver:CPre+SG+P1:CPre+SG+P2
abandonnerait	abandonner	Ver:CPre+SG+P3
abandonneras	abandonner	Ver:IFut+SG+P2
abandonnerent	abandonner	Ver:IPSim+PL+P3
abandonnerez	abandonner	Ver:IFut+PL+P2
abandonneriez	abandonner	Ver:CPre+PL+P2
louperaient	louper	Ver:CPre+PL+P3
louperai	louper	Ver:IFut+SG+P1
louperais	louper	Ver:CPre+SG+P1:CPre+SG+P2
louperait	louper	Ver:CPre+SG+P3
loupera	louper	Ver:IFut+SG+P3
louperas	louper	Ver:IFut+SG+P2
louperent	louper	Ver:IPSim+PL+P3
louperez	louper	Ver:IFut+PL+P2
louperiez	louper	Ver:CPre+PL+P2
louperions	louper	Ver:CPre+PL+P1
louper	louper	Ver:Inf
louperons	louper	Ver:IFut+PL+P1
louperont	louper	Ver:IFut+PL+P3
loupes	loupe	Adj:Mas+PL
loupes	loupe	Nom:Fem+PL
loupes	loupe	Nom:Mas+PL
loupes	louper	Ver:IPre+SG+P2:SPre+SG+P2
loupes	louper	Ver:PPas+Mas+PL
loupez	louper	Ver:IPre+PL+P2:ImPre+PL+P2
loupiez	louper	Ver:IImp+PL+P2:SPre+PL+P2
loupions	louper	Ver:IImp+PL+P1:SPre+PL+P1
residerez	resider	Ver:IFut+PL+P2
resideriez	resider	Ver:CPre+PL+P2
residerions	resider	Ver:CPre+PL+P1
residerons	resider	Ver:IFut+PL+P1
resideront	resider	Ver:IFut+PL+P3
resider	resider	Ver:Inf
resides	resider	Ver:IPre+SG+P2
resides	resider	Ver:SPre+SG+P2
residez	resider	Ver:IPre+PL+P2:ImPre+PL+P2
residiez	resider	Ver:IImp+PL+P2:SPre+PL+P2
residions	resider	Ver:IImp+PL+P1:SPre+PL+P1
residons	resider	Ver:IPre+PL+P1:ImPre+PL+P1
defigurerent	defigurer	Ver:IPSim+PL+P3
defigurerez	defigurer	Ver:IFut+PL+P2
defigureriez	defigurer	Ver:CPre+PL+P2
defigurerions	defigurer	Ver:CPre+PL+P1
defigurerons	defigurer	Ver:IFut+PL+P1
defigureront	defigurer	Ver:IFut+PL+P3
defigures	defigurer	Ver:IPre+SG+P2:SPre+SG+P2
defigures	defigurer	Ver:PPas+Mas+PL
defigurez	defigurer	Ver:IPre+PL+P2:ImPre+PL+P2
defiguriez	defigurer	Ver:IImp+PL+P2:SPre+PL+P2
defigurions	defigurer	Ver:IImp+PL+P1:SPre+PL+P1
defigurons	defigurer	Ver:IPre+PL+P1:ImPre+PL+P1
chaleureusement	chaleureusement	Adv
entrepot	entrepot	Nom:Mas+SG
entrepots	entrepot	Nom:Mas+PL
entreprenaient	entreprendre	Ver:IImp+PL+P3
entreprenais	entreprendre	Ver:IImp+SG+P1:IImp+SG+P2
entreprenait	entreprendre	Ver:IImp+SG+P3
entreprenante	entreprenant	Adj:Fem+SG
entreprenante	entreprenant	Nom:Fem+SG
entreprenant	entreprenant	Adj:Mas+SG
entreprenant	entreprenant	Nom:Mas+SG
entreprenant	entreprendre	Ver:PPre
entreprenantes	entreprenant	Adj:Fem+PL
entreprenantes	entreprenant	Nom:Fem+PL
entreprenants	entreprenant	Adj:Mas+PL
entreprenants	entreprenant	Nom:Mas+PL
entreprend	entreprendre	Ver:IPre+SG+P3
entreprendra	entreprendre	Ver:IFut+SG+P3
entreprendraient	entreprendre	Ver:CPre+PL+P3
entreprendrai	entreprendre	Ver:IFut+SG+P1
entreprendrais	entreprendre	Ver:CPre+SG+P1:CPre+SG+P2
entreprendrait	entreprendre	Ver:CPre+SG+P3
entreprendras	entreprendre	Ver:IFut+SG+P2
entreprendre	entreprendre	Ver:Inf
entreprendrez	entreprendre	Ver:IFut+PL+P2
entreprendriez	entreprendre	Ver:CPre+PL+P2
entreprendrions	entreprendre	Ver:CPre+PL+P1
entreprendrons	entreprendre	Ver:IFut+PL+P1
entreprendront	entreprendre	Ver:IFut+PL+P3
entreprends	entreprendre	Ver:IPre+SG+P1:IPre+SG+P2:ImPre+SG+P2
entrepreneur	entrepreneur	Nom:Mas+SG
entrepreneurs	entrepreneur	Nom:Mas+PL
entrepreneuse	entrepreneur	Nom:Fem+SG
entreprenez	entreprendre	Ver:IPre+PL+P2:ImPre+PL+P2
entrepreniez	entreprendre	Ver:IImp+PL+P2:SPre+PL+P2
entreprenions	entreprendre	Ver:IImp+PL+P1:SPre+PL+P1
entreprenne	entreprendre	Ver:SPre+SG+P1:SPre+SG+P3
entreprennent	entreprendre	Ver:IPre+PL+P3:SPre+PL+P3
entreprennes	entreprendre	Ver:SPre+SG+P2
entreprenons	entreprendre	Ver:Imp+PL+P1
entreprenons	entreprendre	Ver:IPre+PL+P1
entreprimes	entreprendre	Ver:IPSim+PL+P1
entreprirent	entreprendre	Ver:IPSim+PL+P3
entreprise	entreprendre	Ver:PPas+Fem+SG
marmitez	marmiter	Ver:IPre+PL+P2:ImPre+PL+P2
marmitiez	marmiter	Ver:IImp+PL+P2:SPre+PL+P2
marmitions	marmiter	Ver:IImp+PL+P1:SPre+PL+P1
marmiton	marmiton	Nom:Mas+SG
marmitons	marmiter	Ver:IPre+PL+P1:ImPre+PL+P1
marmitons	marmiton	Nom:Mas+PL
marmonnaient	marmonner	Ver:IImp+PL+P3
marmonnai	marmonner	Ver:IPSim+SG+P1
marmonnais	marmonner	Ver:IImp+SG+P1
marmonnais	marmonner	Ver:IImp+SG+P2
marmonnait	marmonner	Ver:IImp+SG+P3
marmonna	marmonner	Ver:IPSim+SG+P3
marmonnames	marmonner	Ver:IPSim+PL+P1
marmonnant	marmonner	Ver:PPre
marmonnas	marmonner	Ver:IPSim+SG+P2
marmonnasse	marmonner	Ver:SImp+SG+P1
marmonnassent	marmonner	Ver:SImp+PL+P3
marmonnasses	marmonner	Ver:SImp+SG+P2
marmonnassiez	marmonner	Ver:SImp+PL+P2
marmonnassions	marmonner	Ver:SImp+PL+P1
marmonnates	marmonner	Ver:IPSim+PL+P2
marmonnat	marmonner	Ver:SImp+SG+P3
marmonnee	marmonner	Ver:PPas+Fem+SG
marmonnees	marmonner	Ver:PPas+Fem+PL
marmonne	marmonner	Ver:IPre+SG+P1:IPre+SG+P3:SPre+SG+P1:SPre+SG+P3:ImPre+SG+P2
marmonne	marmonner	Ver:PPas+Mas+SG
marmonnement	marmonnement	Nom:Mas+SG
marmonnements	marmonnement	Nom:Mas+PL
marmonnent	marmonner	Ver:IPre+PL+P3:SPre+PL+P3
marmonneraient	marmonner	Ver:CPre+PL+P3
marmonnerai	marmonner	Ver:IFut+SG+P1
marmonnerais	marmonner	Ver:CPre+SG+P1:CPre+SG+P2
marmonnerait	marmonner	Ver:CPre+SG+P3
marmonnera	marmonner	Ver:IFut+SG+P3
marmonneras	marmonner	Ver:IFut+SG+P2
marmonnerent	marmonner	Ver:IPSim+PL+P3
marmonnerez	marmonner	Ver:IFut+PL+P2
marmonneriez	marmonner	Ver:CPre+PL+P2
marmonnerions	marmonner	Ver:CPre+PL+P1
marmonner	marmonner	Ver:Inf
marmonnerons	marmonner	Ver:IFut+PL+P1
marmonneront	marmonner	Ver:IFut+PL+P3
marmonnes	marmonner	Ver:IPre+SG+P2:SPre+SG+P2
marmonnes	marmonner	Ver:PPas+Mas+PL
marmonnez	marmonner	Ver:Imp+PL+P2
marmonnez	marmonner	Ver:IPre+PL+P2
marmonniez	marmonner	Ver:IImp+PL+P2:SPre+PL+P2
marmonnions	marmonner	Ver:IImp+PL+P1:SPre+PL+P1
marmonnons	marmonner	Ver:Imp+PL+P1
marmonnons	marmonner	Ver:IPre+PL+P1
marmoreen	marmoreen	Adj:Mas+SG
marmoreenne	marmoreen	Adj:Fem+SG
marmoreennes	marmoreen	Adj:Fem+PL
marmoreens	marmoreen	Adj:Mas+PL
marmorisant	marmoriser	Ver:PPre
marmorise	marmoriser	Ver:PPas+Mas+SG
marmoriser	marmoriser	Ver:Inf
marmot	marmot	Nom:Mas+SG
marmots	marmot	Nom:Mas+PL
marmottaient	marmotter	Ver:IImp+PL+P3
marmottai	marmotter	Ver:IPSim+SG+P1
marmottais	marmotter	Ver:IImp+SG+P1:IImp+SG+P2
marmottait	marmotter	Ver:IImp+SG+P3
marmotta	marmotter	Ver:IPSim+SG+P3
marmottames	marmotter	Ver:IPSim+PL+P1
marmottant	marmotter	Ver:PPre
marmottas	marmotter	Ver:IPSim+SG+P2
marmottasse	marmotter	Ver:SImp+SG+P1
marmottassent	marmotter	Ver:SImp+PL+P3
marmottasses	marmotter	Ver:SImp+SG+P2
marmottassiez	marmotter	Ver:SImp+PL+P2
marmottassions	marmotter	Ver:SImp+PL+P1
marmotte	marmotte	Nom:Fem+SG
ontologiquement	ontologiquement	Adv
adroitement	adroitement	Adv
zython	zython	Nom:Mas+SG